#####################
#########...#########
########.....########
#######.......#######
######..#...#..######
#####..##...##..#####
####..###...###..####
###..####...####..###
##..#####...#####..##
#...................#
#...................#
#...................#
##..#####...#####..##
###..####...####..###
####..###...###..####
#####..##.@.##..#####
######..#...#..######
#######.......#######
########.....########
#########...#########
#####################